"a" = (/turf/closed/wall/mineral/uranium{rad_flags = 0},/area/template_noop)
"b" = (/obj/structure/table/wood/fancy,/obj/structure/displaycase/forsale/kitchen{pixel_y = 9},/obj/machinery/airalarm{dir = 1; pixel_y = -22},/obj/machinery/light{dir = 8},/turf/open/floor/carpet,/area/template_noop)
"c" = (/obj/machinery/computer/security/telescreen/entertainment{pixel_y = 31},/turf/open/floor/plasteel/cult,/area/template_noop)
"d" = (/obj/machinery/disposal/bin,/obj/machinery/light_switch{pixel_x = 25},/obj/machinery/light_switch{pixel_x = 25},/obj/structure/disposalpipe/trunk{dir = 8},/obj/machinery/light/small{dir = 4},/turf/open/floor/plasteel/cult,/area/template_noop)
"e" = (/obj/structure/chair/wood/wings,/turf/open/floor/plasteel/cult,/area/template_noop)
"f" = (/obj/structure/table/wood/poker,/obj/machinery/chem_dispenser/drinks{dir = 4; pixel_x = -4; pixel_y = 4},/obj/machinery/light/small{brightness = 3; dir = 8},/turf/open/floor/plasteel/cult,/area/template_noop)
"g" = (/obj/machinery/vending/boozeomat,/turf/closed/wall/mineral/uranium{rad_flags = 0},/area/template_noop)
"h" = (/obj/machinery/door/airlock{icon = 'icons/obj/doors/airlocks/station/uranium.dmi'; name = "Bar"},/obj/machinery/atmospherics/pipe/simple/scrubbers/hidden/layer3{dir = 4},/obj/machinery/atmospherics/pipe/simple/supply/hidden/layer1{dir = 4},/turf/open/floor/plasteel/cult,/area/template_noop)
"i" = (/turf/open/floor/plasteel/cult,/area/template_noop)
"j" = (/obj/structure/chair/wood/wings{dir = 1},/obj/structure/chair/wood/wings{dir = 1},/obj/structure/chair/wood/wings{dir = 1},/obj/structure/chair/wood/wings{dir = 1},/turf/open/floor/plasteel/cult,/area/template_noop)
"k" = (/obj/structure/table/wood/poker,/obj/item/reagent_containers/food/snacks/burger/spell,/obj/machinery/atmospherics/pipe/simple/scrubbers/hidden/layer3{dir = 4},/obj/machinery/atmospherics/pipe/manifold/supply/hidden/layer1,/turf/open/floor/carpet,/area/template_noop)
"n" = (/obj/structure/table/wood/poker,/obj/item/toy/figure/wizard,/turf/open/floor/plasteel/cult,/area/template_noop)
"q" = (/obj/machinery/newscaster{pixel_x = 32; pixel_y = 2},/turf/open/floor/plasteel/cult,/area/template_noop)
"r" = (/obj/structure/table/wood/poker,/turf/open/floor/plasteel/cult,/area/template_noop)
"s" = (/obj/machinery/door/airlock{icon = 'icons/obj/doors/airlocks/station/uranium.dmi'; name = "Personal Quarters"; req_access = null; req_access_txt = 25},/obj/structure/disposalpipe/segment,/turf/open/floor/plasteel/cult,/area/template_noop)
"t" = (/obj/structure/chair/wood/wings,/obj/machinery/atmospherics/components/unary/vent_pump/on/layer1,/turf/open/floor/plasteel/cult,/area/template_noop)
"u" = (/obj/structure/chair/wood/wings{dir = 1},/obj/effect/landmark/start/assistant,/turf/open/floor/plasteel/cult,/area/template_noop)
"v" = (/obj/structure/table/wood/poker,/obj/item/toy/cards/deck,/obj/machinery/atmospherics/pipe/simple/supply/hidden/layer1{dir = 4},/obj/machinery/atmospherics/pipe/manifold/scrubbers/hidden/layer3,/turf/open/floor/carpet,/area/template_noop)
"w" = (/obj/structure/table/wood/poker,/obj/item/storage/pill_bottle/dice{icon_state = "magicdicebag"},/turf/open/floor/plasteel/cult,/area/template_noop)
"x" = (/obj/structure/table/wood/poker,/obj/machinery/chem_dispenser/drinks/beer{dir = 4; pixel_x = -5},/obj/machinery/firealarm{dir = 4; pixel_x = -26},/turf/open/floor/plasteel/cult,/area/template_noop)
"y" = (/obj/effect/spawner/structure/window/reinforced{color = "#008000"},/turf/open/floor/plasteel/cult,/area/template_noop)
"z" = (/obj/effect/landmark/event_spawn,/turf/open/floor/plasteel/cult,/area/template_noop)
"A" = (/obj/structure/table/wood/poker,/obj/item/storage/fancy/cigarettes/cigars/havana,/obj/item/lighter{pixel_x = 8},/turf/open/floor/plasteel/cult,/area/template_noop)
"B" = (/obj/structure/table/wood/poker,/obj/item/book/manual/wiki/barman_recipes,/turf/open/floor/plasteel/cult,/area/template_noop)
"D" = (/obj/structure/chair/wood/wings,/obj/structure/chair/wood/wings,/obj/machinery/atmospherics/components/unary/vent_scrubber/on/layer3,/turf/open/floor/plasteel/cult,/area/template_noop)
"F" = (/obj/structure/table/wood/fancy,/obj/item/clothing/head/hardhat/cakehat,/obj/machinery/light{dir = 4},/turf/open/floor/carpet,/area/template_noop)
"G" = (/obj/effect/spawner/structure/window/reinforced{color = "#008000"},/obj/effect/spawner/structure/window/reinforced{color = "#008000"},/turf/open/floor/plasteel/cult,/area/template_noop)
"H" = (/mob/living/carbon/monkey/punpun,/turf/open/floor/plasteel/cult,/area/template_noop)
"I" = (/obj/structure/table/wood/poker,/obj/item/reagent_containers/glass/rag,/obj/item/flashlight/lamp{pixel_x = -2; pixel_y = 9},/turf/open/floor/plasteel/cult,/area/template_noop)
"K" = (/obj/machinery/door/airlock{icon = 'icons/obj/doors/airlocks/station/uranium.dmi'; name = "Bar"},/turf/open/floor/plasteel/cult,/area/template_noop)
"M" = (/obj/machinery/smartfridge/drinks{icon_state = "boozeomat"},/turf/closed/wall/mineral/uranium{rad_flags = 0},/area/template_noop)
"P" = (/obj/structure/chair/wood/wings{dir = 1},/turf/open/floor/plasteel/cult,/area/template_noop)
"Q" = (/obj/machinery/atmospherics/pipe/simple/scrubbers/hidden/layer3{dir = 4},/obj/machinery/atmospherics/pipe/simple/supply/hidden/layer1{dir = 4},/turf/open/floor/plasteel/cult,/area/template_noop)
"S" = (/obj/structure/disposalpipe/segment{dir = 5},/turf/open/floor/plasteel/cult,/area/template_noop)
"V" = (/obj/machinery/door/airlock{icon = 'icons/obj/doors/airlocks/station/uranium.dmi'; name = "Bar Access"; req_access_txt = 25},/turf/open/floor/plasteel/cult,/area/template_noop)
"W" = (/obj/effect/landmark/start/bartender,/turf/open/floor/plasteel/cult,/area/template_noop)
"X" = (/obj/structure/table/wood/poker,/obj/item/clothing/head/wizard,/turf/open/floor/plasteel/cult,/area/template_noop)

(1,1,1) = {"
aABIgasaa
axiiicSda
afiWHWizV
anrrXrrwM
GiPzPijqa
KiiDitiiK
hQQvQkQQh
yiiuiPiia
abeieieFa
"}
