"a" = (/turf/closed/wall/mineral/bronze,/area/template_noop)
"b" = (/obj/structure/table/bronze,/obj/item/clothing/suit/bronze,/turf/open/floor/bronze,/area/template_noop)
"d" = (/obj/item/clockwork/alloy_shards/clockgolem_remains,/turf/open/floor/bronze,/area/template_noop)
"e" = (/obj/machinery/door/airlock/bronze/seethru{name = "Bar Access"; req_access_txt = "25"},/obj/machinery/door/poddoor/preopen{id = "barShutters"; name = "privacy shutters"},/turf/open/floor/bronze,/area/template_noop)
"f" = (/obj/item/toy/plush/moth/ookplush,/turf/open/floor/bronze,/area/template_noop)
"g" = (/obj/structure/chair/bronze{dir = 4},/obj/machinery/atmospherics/components/unary/vent_pump/on/layer1{dir = 4},/turf/open/floor/bronze,/area/template_noop)
"h" = (/obj/item/clockwork/alloy_shards/large,/turf/open/floor/bronze,/area/template_noop)
"k" = (/obj/structure/table/bronze,/obj/machinery/chem_dispenser/drinks{dir = 4},/turf/open/floor/bronze,/area/template_noop)
"l" = (/obj/effect/landmark/start/bartender,/turf/open/floor/bronze,/area/template_noop)
"m" = (/obj/item/clockwork/alloy_shards/small,/turf/open/floor/bronze,/area/template_noop)
"n" = (/obj/machinery/door/airlock/bronze/seethru,/obj/machinery/door/poddoor/preopen{id = "barShutters"; name = "privacy shutters"},/obj/machinery/door/firedoor,/turf/open/floor/bronze,/area/template_noop)
"o" = (/obj/effect/landmark/start/assistant,/turf/open/floor/bronze,/area/template_noop)
"p" = (/obj/machinery/atmospherics/pipe/simple/scrubbers/hidden/layer3,/obj/machinery/atmospherics/pipe/simple/supply/hidden/layer1{dir = 1},/turf/open/floor/bronze,/area/template_noop)
"q" = (/obj/structure/table/bronze,/obj/item/clothing/head/bronze,/turf/open/floor/bronze,/area/template_noop)
"r" = (/obj/structure/table/bronze,/obj/item/clothing/head/bronze,/obj/machinery/light/floor,/obj/machinery/atmospherics/pipe/simple/scrubbers/hidden/layer3{dir = 5},/obj/machinery/atmospherics/pipe/simple/supply/hidden/layer1{dir = 9},/turf/open/floor/bronze,/area/template_noop)
"s" = (/obj/structure/chair/bronze{dir = 8},/turf/open/floor/bronze,/area/template_noop)
"t" = (/obj/structure/chair/bronze{dir = 8},/obj/machinery/atmospherics/components/unary/vent_scrubber/on/layer3{dir = 8},/turf/open/floor/bronze,/area/template_noop)
"u" = (/obj/machinery/vending/boozeomat,/turf/closed/wall/mineral/bronze,/area/template_noop)
"v" = (/obj/structure/sink/kitchen{dir = 8; pixel_x = 11},/turf/open/floor/bronze,/area/template_noop)
"w" = (/turf/open/floor/bronze,/area/template_noop)
"x" = (/obj/structure/table/bronze,/obj/item/stack/tile/bronze/thirty,/turf/open/floor/bronze,/area/template_noop)
"y" = (/obj/effect/landmark/start/assistant,/obj/machinery/atmospherics/pipe/simple/scrubbers/hidden/layer3{dir = 8},/obj/machinery/atmospherics/pipe/simple/supply/hidden/layer1{dir = 8},/turf/open/floor/bronze,/area/template_noop)
"z" = (/obj/structure/chair/bronze{dir = 4},/obj/machinery/light{dir = 8},/turf/open/floor/bronze,/area/template_noop)
"A" = (/obj/structure/table/bronze,/obj/item/toy/plush/plushvar,/obj/machinery/atmospherics/pipe/simple/supply/hidden/layer1{dir = 1},/obj/machinery/atmospherics/pipe/simple/scrubbers/hidden/layer3,/turf/open/floor/bronze,/area/template_noop)
"B" = (/obj/structure/disposalpipe/segment{dir = 9},/turf/open/floor/bronze,/area/template_noop)
"C" = (/obj/effect/landmark/event_spawn,/turf/open/floor/bronze,/area/template_noop)
"D" = (/obj/structure/chair/bronze{dir = 8},/obj/item/clockwork/alloy_shards,/turf/open/floor/bronze,/area/template_noop)
"E" = (/obj/item/clockwork/alloy_shards,/obj/machinery/atmospherics/pipe/simple/scrubbers/hidden/layer3{dir = 8},/obj/machinery/atmospherics/pipe/simple/supply/hidden/layer1{dir = 8},/turf/open/floor/bronze,/area/template_noop)
"F" = (/obj/structure/sign/barsign,/turf/closed/wall/mineral/bronze,/area/template_noop)
"G" = (/obj/machinery/computer/arcade{dir = 8; pixel_x = 4},/turf/open/floor/bronze,/area/template_noop)
"H" = (/obj/machinery/atmospherics/pipe/simple/scrubbers/hidden/layer3{dir = 9},/obj/machinery/atmospherics/pipe/simple/supply/hidden/layer1{dir = 9},/turf/open/floor/bronze,/area/template_noop)
"I" = (/obj/effect/spawner/xmastree,/turf/open/floor/bronze,/area/template_noop)
"J" = (/obj/structure/table/bronze,/obj/item/clothing/shoes/bronze,/turf/open/floor/bronze,/area/template_noop)
"K" = (/obj/structure/table/bronze,/obj/item/clothing/shoes/bronze,/obj/item/clothing/suit/bronze,/obj/item/clothing/head/bronze,/turf/open/floor/bronze,/area/template_noop)
"L" = (/obj/structure/chair/bronze{dir = 4},/turf/open/floor/bronze,/area/template_noop)
"M" = (/obj/structure/table/bronze,/obj/machinery/door/poddoor/preopen{id = "barShutters"; name = "privacy shutters"},/turf/open/floor/bronze,/area/template_noop)
"N" = (/mob/living/carbon/monkey/punpun,/turf/open/floor/bronze,/area/template_noop)
"O" = (/obj/item/clockwork/alloy_shards,/turf/open/floor/bronze,/area/template_noop)
"P" = (/obj/structure/table/bronze,/obj/machinery/chem_dispenser/drinks/beer{dir = 4},/turf/open/floor/bronze,/area/template_noop)
"Q" = (/obj/machinery/light{dir = 1},/turf/open/floor/bronze,/area/template_noop)
"R" = (/obj/effect/landmark/start/assistant,/obj/machinery/atmospherics/pipe/simple/scrubbers/hidden/layer3{dir = 6},/obj/machinery/atmospherics/pipe/simple/supply/hidden/layer1{dir = 6},/turf/open/floor/bronze,/area/template_noop)
"S" = (/obj/item/clockwork/alloy_shards/medium,/turf/open/floor/bronze,/area/template_noop)
"T" = (/obj/machinery/firealarm{pixel_y = -30},/obj/machinery/light,/turf/open/floor/bronze,/area/template_noop)
"U" = (/obj/structure/disposalpipe/trunk{dir = 4},/obj/machinery/disposal/bin,/obj/machinery/button/door{id = "barShutters"; name = "bar shutters"; pixel_x = 4; pixel_y = 28},/turf/open/floor/bronze,/area/template_noop)
"V" = (/obj/machinery/light,/turf/open/floor/bronze,/area/template_noop)
"W" = (/obj/structure/window/bronze/fulltile,/obj/machinery/door/poddoor/preopen{id = "barShutters"; name = "privacy shutters"},/turf/open/floor/bronze,/area/template_noop)
"X" = (/obj/machinery/atmospherics/pipe/simple/scrubbers/hidden/layer3{dir = 8},/obj/machinery/atmospherics/pipe/simple/supply/hidden/layer1{dir = 8},/turf/open/floor/bronze,/area/template_noop)
"Y" = (/obj/structure/table/bronze,/obj/item/reagent_containers/glass/rag{pixel_x = 4; pixel_y = 14},/obj/item/book/manual/wiki/barman_recipes,/obj/machinery/firealarm{dir = 4; pixel_x = -26},/turf/open/floor/bronze,/area/template_noop)

(1,1,1) = {"
awwwwwwwwpLMUBQ
awohwREXyHLMwwv
WLxDLAsLxsLMlww
azqsgrtLqsLMwww
nLbsLbsLbswaPww
azJsLJsLJswewCw
WwNwIOCwSwwakwK
afmwTwwwVdGaYVu
aaaaanWnFaaaaaa
"}
