"ax" = (/obj/machinery/door/airlock{name = "Theatre Storage"; req_access_txt = "46"},/obj/structure/disposalpipe/segment,/turf/open/floor/plasteel/dark,/area/template_noop)
"aT" = (/obj/structure/disposalpipe/segment{dir = 4},/obj/machinery/light/small,/turf/open/floor/plasteel/dark,/area/template_noop)
"bx" = (/obj/structure/disposalpipe/trunk{dir = 8},/obj/machinery/disposal/bin,/turf/open/floor/pod/dark,/area/template_noop)
"du" = (/obj/structure/table/reinforced,/obj/item/reagent_containers/glass/rag{pixel_x = 4; pixel_y = 14},/obj/item/book/manual/wiki/barman_recipes,/turf/open/floor/plasteel/dark,/area/template_noop)
"en" = (/obj/effect/turf_decal/tile/red{dir = 4},/obj/effect/turf_decal/tile/red,/obj/structure/disposalpipe/segment,/turf/open/floor/plasteel/dark,/area/template_noop)
"ey" = (/obj/structure/table,/mob/living/carbon/monkey/punpun{name = "Deck Hand Pun Pun V"},/obj/item/mop,/obj/item/reagent_containers/glass/bucket,/obj/effect/spawner/bundle/costume/pirate,/obj/item/toy/sword,/turf/open/floor/pod/light,/area/template_noop)
"fO" = (/obj/structure/chair/stool,/obj/structure/sign/poster/contraband/revolver{pixel_x = 32},/obj/machinery/light/small{dir = 4},/turf/open/floor/pod/light,/area/template_noop)
"gq" = (/obj/structure/disposalpipe/segment,/turf/open/floor/pod/dark,/area/template_noop)
"gs" = (/obj/effect/turf_decal/tile/blue{dir = 4},/obj/effect/turf_decal/tile/blue{dir = 8},/obj/effect/turf_decal/tile/red,/obj/effect/turf_decal/tile/red{dir = 1},/obj/structure/disposalpipe/sorting/mail{dir = 4; sortType = 18},/obj/machinery/requests_console{department = "Theatre"; departmentType = 0; name = "theatre RC"; pixel_x = -32; pixel_y = -32},/obj/machinery/atmospherics/components/unary/vent_scrubber/on/layer3{dir = 4},/turf/open/floor/plasteel/dark,/area/template_noop)
"hs" = (/obj/effect/turf_decal/tile/red{dir = 1},/obj/effect/turf_decal/tile/red{dir = 8},/obj/machinery/newscaster{pixel_x = -32; pixel_y = 1},/obj/machinery/atmospherics/pipe/simple/scrubbers/hidden/layer3,/obj/machinery/atmospherics/pipe/simple/supply/hidden/layer1,/turf/open/floor/plasteel/dark,/area/template_noop)
"hA" = (/obj/structure/chair/stool,/obj/machinery/atmospherics/components/unary/vent_scrubber/on/layer3{dir = 8},/turf/open/floor/pod/light,/area/template_noop)
"hT" = (/obj/machinery/requests_console{department = "Bar"; departmentType = 2; pixel_y = 30; receive_ore_updates = 1},/obj/structure/cable/yellow{icon_state = "4-8"},/obj/machinery/camera{c_tag = "Bar Access"; dir = 2},/turf/open/floor/plasteel/dark,/area/template_noop)
"hU" = (/obj/structure/table/reinforced,/obj/machinery/chem_dispenser/drinks/beer,/turf/open/floor/plasteel/dark,/area/template_noop)
"hX" = (/obj/effect/turf_decal/tile/blue{dir = 4},/obj/effect/turf_decal/tile/blue{dir = 8},/obj/effect/turf_decal/tile/red,/obj/effect/turf_decal/tile/red{dir = 1},/obj/structure/cable/yellow{icon_state = "4-8"},/turf/open/floor/plasteel/dark,/area/template_noop)
"iC" = (/obj/structure/table,/mob/living/carbon/monkey/punpun{name = "Crewmate Pun Pun VI"},/obj/item/toy/gun,/obj/item/toy/sword,/obj/structure/disposalpipe/segment,/obj/effect/spawner/bundle/costume/pirate,/turf/open/floor/pod/light,/area/template_noop)
"iG" = (/obj/effect/turf_decal/tile/blue{dir = 4},/obj/effect/turf_decal/tile/blue{dir = 8},/obj/effect/turf_decal/tile/red,/obj/effect/turf_decal/tile/red{dir = 1},/obj/structure/closet/crate/wooden/toy,/obj/item/lipstick/random,/obj/item/clothing/gloves/color/rainbow,/turf/open/floor/plasteel/dark,/area/template_noop)
"iU" = (/obj/machinery/vending/cigarette/syndicate,/obj/machinery/light/small,/turf/open/floor/pod/dark,/area/template_noop)
"jn" = (/obj/effect/turf_decal/tile/blue{dir = 4},/obj/effect/turf_decal/tile/blue{dir = 8},/obj/effect/turf_decal/tile/red,/obj/effect/turf_decal/tile/red{dir = 1},/obj/structure/disposalpipe/segment{dir = 4},/obj/machinery/camera{c_tag = "Theatre Storage"; dir = 1},/turf/open/floor/plasteel/dark,/area/template_noop)
"jA" = (/obj/machinery/door/airlock{name = "Bar Access"; req_access_txt = "25"},/turf/open/floor/plasteel/dark,/area/template_noop)
"jF" = (/obj/machinery/door/airlock{name = "Service Access"; req_access_txt = "0"; req_one_access_txt = "22;25;26;28;35;37;38;46"},/obj/structure/disposalpipe/segment,/turf/open/floor/plasteel/dark,/area/template_noop)
"kk" = (/mob/living/carbon/monkey/punpun{name = "First Mate Pun Pun II"},/obj/effect/spawner/bundle/costume/pirate,/obj/item/clothing/head/pirate,/obj/item/toy/gun,/obj/item/toy/sword,/obj/item/toy/redbutton,/turf/open/floor/pod/dark,/area/template_noop)
"lg" = (/turf/open/floor/plasteel/dark,/area/template_noop)
"lp" = (/obj/structure/sign/poster/contraband/clown{pixel_y = 32},/obj/structure/dresser,/turf/open/floor/plasteel/dark,/area/template_noop)
"mI" = (/obj/effect/turf_decal/tile/blue{dir = 4},/obj/effect/turf_decal/tile/blue{dir = 8},/obj/effect/turf_decal/tile/red,/obj/effect/turf_decal/tile/red{dir = 1},/obj/structure/table/wood,/obj/item/soap,/obj/item/toy/cattoy,/turf/open/floor/plasteel/dark,/area/template_noop)
"mR" = (/obj/machinery/door/airlock/maintenance{name = "Theatre Maintenance"; req_access_txt = "46"},/obj/structure/disposalpipe/segment,/obj/structure/cable/yellow{icon_state = "1-2"},/obj/machinery/atmospherics/pipe/simple/supply/hidden/layer1,/obj/machinery/atmospherics/pipe/simple/scrubbers/hidden/layer3,/turf/open/floor/plating,/area/template_noop)
"nn" = (/obj/effect/landmark/start/bartender,/turf/open/floor/plasteel/dark,/area/template_noop)
"pE" = (/obj/machinery/atmospherics/pipe/simple/scrubbers/hidden/layer3{dir = 4},/obj/machinery/atmospherics/components/unary/vent_pump/on/layer1{dir = 8},/turf/open/floor/plasteel/dark,/area/template_noop)
"pP" = (/obj/effect/turf_decal/tile/red{dir = 4},/obj/effect/turf_decal/tile/red,/obj/structure/disposalpipe/trunk,/obj/machinery/disposal/bin,/obj/machinery/button/door{id = "barshutters"; name = "Bar Lockdown"; pixel_x = 28; req_access_txt = "25"},/obj/item/radio/intercom{pixel_y = 26},/turf/open/floor/plasteel/dark,/area/template_noop)
"qu" = (/obj/structure/disposalpipe/segment{dir = 5},/turf/open/floor/pod/dark,/area/template_noop)
"rr" = (/obj/machinery/door/airlock/public/glass{name = "Bar"},/obj/machinery/door/airlock/public/glass{name = "Bar"},/obj/machinery/door/poddoor/shutters/preopen{id = "barshutters"; name = "bar shutters"},/obj/machinery/door/firedoor,/turf/open/floor/pod/dark,/area/template_noop)
"rM" = (/obj/machinery/airalarm{pixel_y = 24},/obj/machinery/light{dir = 1},/turf/open/floor/plasteel,/area/template_noop)
"sv" = (/obj/structure/table,/mob/living/carbon/monkey/punpun{name = "Crewmate Pun Pun VII"},/obj/item/toy/gun,/obj/item/toy/sword,/obj/effect/spawner/bundle/costume/pirate,/turf/open/floor/pod/light,/area/template_noop)
"sD" = (/turf/open/floor/plasteel,/area/template_noop)
"tf" = (/obj/machinery/firealarm{dir = 8; pixel_x = 28},/obj/structure/disposalpipe/junction/flip{dir = 1},/turf/open/floor/pod/dark,/area/template_noop)
"tq" = (/obj/machinery/atmospherics/pipe/simple/scrubbers/hidden/layer3,/obj/machinery/atmospherics/pipe/simple/supply/hidden/layer1,/turf/open/floor/pod/dark,/area/template_noop)
"tR" = (/obj/structure/chair/stool,/obj/machinery/atmospherics/components/unary/vent_pump/on/layer1{dir = 8},/obj/machinery/atmospherics/pipe/simple/scrubbers/hidden/layer3{dir = 4},/turf/open/floor/pod/light,/area/template_noop)
"vf" = (/obj/structure/chair/stool,/obj/machinery/atmospherics/components/unary/vent_scrubber/on/layer3{dir = 4},/turf/open/floor/pod/light,/area/template_noop)
"xb" = (/obj/structure/extinguisher_cabinet{pixel_y = 30},/obj/machinery/light/small{dir = 1},/obj/structure/disposalpipe/segment{dir = 4},/obj/structure/table/wood,/obj/structure/displaycase/forsale/kitchen{pixel_y = 9},/turf/open/floor/pod/dark,/area/template_noop)
"xj" = (/obj/structure/disposalpipe/segment{dir = 4},/turf/open/floor/plasteel/dark,/area/template_noop)
"xz" = (/obj/structure/table/reinforced,/obj/item/storage/backpack/duffelbag/syndie,/mob/living/carbon/monkey/punpun{name = "Captain Pun Pun"},/obj/effect/turf_decal/tile/red{dir = 8},/obj/effect/turf_decal/tile/red,/obj/item/clothing/suit/pirate/captain,/obj/item/clothing/head/pirate/captain,/turf/open/floor/plasteel/dark,/area/template_noop)
"yr" = (/obj/machinery/door/airlock/public/glass{name = "Bar"},/obj/machinery/door/firedoor,/obj/machinery/atmospherics/pipe/simple/scrubbers/hidden/layer3,/obj/machinery/atmospherics/pipe/simple/supply/hidden/layer1,/turf/open/floor/pod/dark,/area/template_noop)
"yJ" = (/obj/machinery/atmospherics/pipe/simple/scrubbers/hidden/layer3{dir = 4},/obj/machinery/atmospherics/pipe/simple/supply/hidden/layer1{dir = 8},/turf/open/floor/plasteel/dark,/area/template_noop)
"zb" = (/obj/effect/turf_decal/tile/blue{dir = 4},/obj/effect/turf_decal/tile/blue{dir = 8},/obj/effect/turf_decal/tile/red,/obj/effect/turf_decal/tile/red{dir = 1},/obj/structure/disposalpipe/segment{dir = 9},/obj/structure/mirror{pixel_x = 28; pixel_y = -2},/obj/item/cardboard_cutout,/obj/machinery/atmospherics/pipe/simple/scrubbers/hidden/layer3{dir = 9},/obj/machinery/atmospherics/pipe/simple/supply/hidden/layer1{dir = 9},/turf/open/floor/plasteel/dark,/area/template_noop)
"zp" = (/obj/structure/disposalpipe/segment{dir = 4},/obj/machinery/light{light_color = "#c9d3e8"},/obj/machinery/camera{c_tag = "Bar Starboard"; dir = 1},/turf/open/floor/pod/dark,/area/template_noop)
"zM" = (/obj/structure/disposalpipe/segment{dir = 5},/obj/machinery/microwave{pixel_y = 5},/obj/structure/table/wood,/turf/open/floor/pod/dark,/area/template_noop)
"Ap" = (/obj/structure/cable/yellow{icon_state = "4-8"},/turf/open/floor/plasteel/dark,/area/template_noop)
"AG" = (/obj/machinery/computer/arcade/amputation{dir = 8},/turf/open/floor/pod/light,/area/template_noop)
"AS" = (/obj/structure/chair/stool,/obj/structure/chair/stool,/obj/structure/barricade/wooden,/turf/open/floor/pod/light,/area/template_noop)
"Bh" = (/obj/effect/spawner/structure/window,/obj/machinery/door/poddoor/shutters/preopen{id = "barshutters"; name = "bar shutters"},/turf/open/floor/plating,/area/template_noop)
"Bv" = (/obj/machinery/vending/autodrobe,/obj/machinery/computer/security/telescreen/entertainment{pixel_y = 32},/turf/open/floor/plasteel/dark,/area/template_noop)
"BZ" = (/obj/machinery/door/airlock/public/glass{name = "Bar"},/obj/machinery/door/firedoor,/turf/open/floor/pod/dark,/area/template_noop)
"Ds" = (/obj/machinery/light{dir = 1},/turf/open/floor/plasteel,/area/template_noop)
"Dt" = (/obj/structure/barricade/wooden,/obj/structure/sign/poster/contraband/random{pixel_x = 32},/obj/machinery/door/poddoor/shutters/preopen{id = "barshutters"; name = "bar shutters"},/turf/open/floor/pod/dark,/area/template_noop)
"Dz" = (/obj/effect/turf_decal/tile/blue{dir = 4},/obj/effect/turf_decal/tile/blue{dir = 8},/obj/effect/turf_decal/tile/red,/obj/effect/turf_decal/tile/red{dir = 1},/obj/structure/disposalpipe/segment{dir = 6},/turf/open/floor/plasteel/dark,/area/template_noop)
"DE" = (/obj/effect/turf_decal/tile/red{dir = 1},/obj/effect/turf_decal/tile/red{dir = 8},/obj/machinery/atmospherics/pipe/simple/scrubbers/hidden/layer3{dir = 5},/obj/machinery/atmospherics/pipe/simple/supply/hidden/layer1{dir = 5},/turf/open/floor/plasteel/dark,/area/template_noop)
"DJ" = (/obj/structure/disposalpipe/segment{dir = 4},/turf/open/floor/pod/dark,/area/template_noop)
"DP" = (/obj/machinery/door/airlock/public/glass{name = "Bar"},/obj/machinery/door/poddoor/shutters/preopen{id = "barshutters"; name = "bar shutters"},/obj/machinery/door/firedoor,/turf/open/floor/pod/dark,/area/template_noop)
"EE" = (/obj/structure/barricade/wooden,/turf/open/floor/pod/dark,/area/template_noop)
"EZ" = (/obj/structure/sign/barsign,/turf/closed/wall,/area/template_noop)
"Fp" = (/obj/structure/disposalpipe/segment{dir = 10},/obj/structure/cable,/obj/machinery/power/apc{dir = 4; name = "Bar APC"; pixel_x = 24},/turf/open/floor/plasteel/dark,/area/template_noop)
"Fu" = (/obj/structure/chair,/obj/item/clothing/mask/cigarette,/obj/machinery/firealarm{dir = 1; pixel_y = 27},/turf/open/floor/plasteel,/area/template_noop)
"Gb" = (/obj/structure/sign/poster/official/cohiba_robusto_ad{pixel_y = 32},/turf/open/floor/plasteel,/area/template_noop)
"Gh" = (/obj/effect/turf_decal/tile/blue{dir = 4},/obj/effect/turf_decal/tile/blue{dir = 8},/obj/effect/turf_decal/tile/red,/obj/effect/turf_decal/tile/red{dir = 1},/obj/structure/disposalpipe/segment{dir = 4},/obj/machinery/atmospherics/pipe/simple/scrubbers/hidden/layer3{dir = 4},/obj/machinery/atmospherics/components/unary/vent_pump/on/layer1{dir = 4},/obj/effect/landmark/start/clown,/turf/open/floor/plasteel/dark,/area/template_noop)
"GR" = (/obj/effect/turf_decal/tile/blue{dir = 4},/obj/effect/turf_decal/tile/blue{dir = 8},/obj/effect/turf_decal/tile/red,/obj/effect/turf_decal/tile/red{dir = 1},/obj/structure/disposalpipe/segment,/obj/structure/cable/yellow{icon_state = "1-8"},/obj/machinery/light_switch{pixel_x = 24; pixel_y = 24},/obj/structure/mirror{pixel_x = 28; pixel_y = -2},/obj/machinery/atmospherics/pipe/simple/supply/hidden/layer1,/obj/machinery/atmospherics/pipe/simple/scrubbers/hidden/layer3,/turf/open/floor/plasteel/dark,/area/template_noop)
"GS" = (/obj/machinery/firealarm{dir = 1; pixel_y = 27},/obj/structure/table/reinforced,/obj/machinery/chem_dispenser/drinks,/turf/open/floor/plasteel/dark,/area/template_noop)
"Hm" = (/obj/structure/table/reinforced,/obj/effect/turf_decal/tile/red{dir = 8},/obj/effect/turf_decal/tile/red,/obj/effect/turf_decal/tile/red{dir = 1},/obj/effect/spawner/lootdrop/minor/pirate_or_bandana,/turf/open/floor/plasteel/dark,/area/template_noop)
"IU" = (/obj/structure/table,/mob/living/carbon/monkey/punpun{name = "Gunner Pun Pun IV"},/obj/item/toy/gun,/obj/item/pneumatic_cannon,/obj/effect/spawner/bundle/costume/pirate,/turf/open/floor/pod/light,/area/template_noop)
"IW" = (/obj/structure/barricade/wooden,/obj/machinery/door/poddoor/shutters/preopen{id = "barshutters"; name = "bar shutters"},/turf/open/floor/pod/dark,/area/template_noop)
"Jg" = (/obj/machinery/atmospherics/components/unary/vent_scrubber/on/layer3{dir = 8},/turf/open/floor/plasteel/dark,/area/template_noop)
"JC" = (/obj/effect/turf_decal/tile/blue{dir = 4},/obj/effect/turf_decal/tile/blue{dir = 8},/obj/effect/turf_decal/tile/red,/obj/effect/turf_decal/tile/red{dir = 1},/obj/structure/cable/yellow{icon_state = "4-8"},/obj/effect/landmark/start/mime,/turf/open/floor/plasteel/dark,/area/template_noop)
"JD" = (/obj/structure/disposalpipe/sorting/mail/flip{dir = 4; sortType = 19},/turf/open/floor/pod/dark,/area/template_noop)
"JL" = (/obj/effect/turf_decal/tile/red{dir = 1},/obj/effect/turf_decal/tile/red{dir = 8},/turf/open/floor/plasteel/dark,/area/template_noop)
"JS" = (/obj/effect/landmark/start/assistant,/turf/open/floor/pod/light,/area/template_noop)
"JW" = (/obj/effect/turf_decal/tile/neutral,/obj/effect/turf_decal/tile/neutral{dir = 1},/obj/effect/turf_decal/tile/neutral{dir = 4},/obj/effect/turf_decal/tile/neutral{dir = 8},/obj/machinery/disposal/bin,/obj/structure/disposalpipe/trunk{dir = 1},/turf/open/floor/plasteel/dark,/area/template_noop)
"Ky" = (/obj/item/radio/intercom{pixel_y = 26},/obj/structure/cable/yellow{icon_state = "2-8"},/turf/open/floor/plasteel/dark,/area/template_noop)
"KQ" = (/turf/open/floor/pod/dark,/area/template_noop)
"MI" = (/obj/structure/table/wood,/obj/item/reagent_containers/food/drinks/bottle/rum{name = "Captain Pete's Private Reserve Cuban Spaced Rum"; pixel_x = -6; pixel_y = 8},/obj/item/reagent_containers/food/drinks/drinkingglass/shotglass{pixel_x = 6; pixel_y = 12},/obj/item/clothing/mask/cigarette/cigar,/obj/item/storage/box/matches,/obj/structure/disposalpipe/segment{dir = 4},/obj/structure/extinguisher_cabinet{pixel_y = 30},/turf/open/floor/pod/dark,/area/template_noop)
"MM" = (/obj/structure/chair,/obj/item/clothing/head/bowler,/turf/open/floor/plasteel,/area/template_noop)
"MQ" = (/obj/structure/table/reinforced,/obj/effect/turf_decal/tile/red{dir = 8},/obj/effect/turf_decal/tile/red,/turf/open/floor/plasteel/dark,/area/template_noop)
"NH" = (/obj/structure/table,/mob/living/carbon/monkey/punpun{name = "Gunner Pun Pun III"},/obj/item/toy/gun,/obj/item/pneumatic_cannon,/obj/effect/spawner/bundle/costume/pirate,/turf/open/floor/pod/light,/area/template_noop)
"NK" = (/obj/machinery/airalarm{pixel_y = 22},/obj/structure/table/wood,/obj/item/instrument/accordion{pixel_y = 4},/turf/open/floor/plasteel/dark,/area/template_noop)
"Op" = (/obj/machinery/computer/arcade{dir = 8},/turf/open/floor/pod/light,/area/template_noop)
"Pk" = (/obj/structure/chair{dir = 4},/turf/open/floor/plasteel,/area/template_noop)
"Qg" = (/obj/machinery/light/small,/turf/open/floor/pod/dark,/area/template_noop)
"Qw" = (/obj/structure/chair{dir = 8},/turf/open/floor/plasteel,/area/template_noop)
"QQ" = (/obj/structure/chair/stool,/obj/machinery/atmospherics/pipe/simple/supply/hidden/layer1{dir = 6},/obj/machinery/atmospherics/pipe/manifold/scrubbers/hidden/layer3{dir = 1},/turf/open/floor/pod/light,/area/template_noop)
"Rh" = (/obj/machinery/light/small{dir = 1},/turf/open/floor/pod/dark,/area/template_noop)
"RO" = (/obj/structure/barricade/wooden,/obj/structure/sign/poster/contraband/random{pixel_x = -32},/obj/machinery/door/poddoor/shutters/preopen{id = "barshutters"; name = "bar shutters"},/obj/machinery/atmospherics/pipe/simple/scrubbers/hidden/layer3,/obj/machinery/atmospherics/pipe/simple/supply/hidden/layer1,/turf/open/floor/pod/dark,/area/template_noop)
"SD" = (/obj/effect/turf_decal/tile/blue{dir = 4},/obj/effect/turf_decal/tile/blue{dir = 8},/obj/effect/turf_decal/tile/red,/obj/effect/turf_decal/tile/red{dir = 1},/obj/structure/cable/yellow{icon_state = "0-4"},/obj/machinery/power/apc{dir = 8; name = "Theatre APC"; pixel_x = -24},/turf/open/floor/plasteel/dark,/area/template_noop)
"ST" = (/obj/machinery/space_heater,/turf/open/floor/pod/dark,/area/template_noop)
"TA" = (/obj/effect/turf_decal/tile/blue{dir = 4},/obj/effect/turf_decal/tile/blue{dir = 8},/obj/effect/turf_decal/tile/red,/obj/effect/turf_decal/tile/red{dir = 1},/obj/structure/cable/yellow{icon_state = "4-8"},/obj/machinery/light/small{dir = 1},/obj/item/radio/intercom{pixel_y = 26},/turf/open/floor/plasteel/dark,/area/template_noop)
"Ug" = (/obj/machinery/vending/boozeomat,/turf/closed/wall,/area/template_noop)
"Vo" = (/obj/structure/table/reinforced,/obj/effect/spawner/lootdrop/minor/pirate_or_bandana,/obj/effect/turf_decal/tile/red{dir = 8},/obj/effect/turf_decal/tile/red,/turf/open/floor/plasteel/dark,/area/template_noop)
"WB" = (/obj/item/kirbyplants/random,/turf/open/floor/plasteel,/area/template_noop)
"WC" = (/obj/structure/chair/stool,/turf/open/floor/pod/light,/area/template_noop)
"WN" = (/turf/closed/wall,/area/template_noop)
"WW" = (/obj/structure/chair/stool,/obj/machinery/atmospherics/pipe/simple/scrubbers/hidden/layer3{dir = 4},/turf/open/floor/pod/light,/area/template_noop)
"XR" = (/obj/structure/chair/stool,/obj/structure/chair/stool,/turf/open/floor/pod/light,/area/template_noop)
"XS" = (/obj/structure/chair/stool,/obj/structure/disposalpipe/segment,/turf/open/floor/pod/light,/area/template_noop)
"YI" = (/obj/structure/table/reinforced,/obj/effect/turf_decal/tile/red{dir = 8},/obj/effect/turf_decal/tile/red,/obj/effect/turf_decal/tile/red{dir = 4},/obj/structure/disposalpipe/segment,/obj/effect/spawner/lootdrop/minor/pirate_or_bandana,/turf/open/floor/plasteel/dark,/area/template_noop)
"Zp" = (/obj/structure/table,/obj/item/reagent_containers/food/snacks/donut,/turf/open/floor/plasteel,/area/template_noop)
"ZH" = (/obj/structure/table/reinforced,/obj/effect/spawner/bundle/costume/pirate,/obj/machinery/light{dir = 1},/turf/open/floor/plasteel/dark,/area/template_noop)

(1,1,1) = {"
WNUgWNWNhslgGShUZHdupPWNNKlpBvWNmRWN
hTApKyjADEyJpEJgnnlgenWNSDJChXTAGRWN
xjaTFpWNJLlglgnnlglgenWNDzjngsGhzbWN
WNWNjFWNHmMQVoxzVoMQYIWNaxWNJWmIiGWN
KQRhquMIDJDJDJDJDJDJJDxbtfWNWNWNWNWN
JSOpWCWCWCWCWCWCWCWCWCWCXSWCWCWCfOWN
JSAGWCNHWCWCIUWCWCeyWCWCiCWCWCsvWCWN
JSOpWCvfWWWWQQtRWWWWWWhAXSWCWCXRASDP
KQKQKQKQKQKQtqkkKQKQKQKQgqKQKQKQEEDP
KQiUSTKQKQQgtqKQKQQgKQKQzMzpDJDJbxWN
BhEZWNBhBhWNROIWDtWNBhBhWNWNrrDPWNWN
QwDsPkZpQwWNyrBZBZWNWBMMFurMsDsDGbWN
"}
