"a" = (/turf/open/floor/carpet,/area/shuttle/escape)
"h" = (/obj/effect/portal/permanent{id = "11-16"},/turf/open/floor/carpet,/area/shuttle/escape)
"j" = (/obj/effect/portal/permanent{id = "9-11"},/turf/open/floor/carpet,/area/shuttle/escape)
"F" = (/obj/effect/portal/permanent{id = "11-12"},/turf/open/floor/carpet,/area/shuttle/escape)

(1,1,1) = {"
aFa
jah
aaa
"}
