"a" = (/turf/open/floor/carpet,/area/shuttle/escape)
"m" = (/obj/effect/portal/permanent{id = "1-2"},/turf/open/floor/carpet,/area/shuttle/escape)
"o" = (/obj/effect/portal/permanent{id = "1-12"},/turf/open/floor/carpet,/area/shuttle/escape)
"z" = (/obj/effect/portal/permanent{id = "1-5"},/turf/open/floor/carpet,/area/shuttle/escape)
"K" = (/obj/effect/portal/permanent{id = "1-4"},/turf/open/floor/carpet,/area/shuttle/escape)

(1,1,1) = {"
aza
maK
aoa
"}
