"a" = (/turf/open/floor/carpet,/area/shuttle/escape)
"c" = (/obj/effect/portal/permanent{id = "9-11"},/turf/open/floor/carpet,/area/shuttle/escape)
"m" = (/obj/effect/portal/permanent{id = "4-9"},/turf/open/floor/carpet,/area/shuttle/escape)
"P" = (/obj/effect/portal/permanent{id = "9-8"},/turf/open/floor/carpet,/area/shuttle/escape)

(1,1,1) = {"
aPa
mac
aaa
"}
