"a" = (/turf/open/floor/carpet,/area/shuttle/escape)
"i" = (/obj/effect/portal/permanent{id = "3-14"},/turf/open/floor/carpet,/area/shuttle/escape)
"A" = (/obj/effect/portal/permanent{id = "3-5"},/turf/open/floor/carpet,/area/shuttle/escape)
"T" = (/obj/effect/portal/permanent{id = "3-10"},/turf/open/floor/carpet,/area/shuttle/escape)

(1,1,1) = {"
aTa
Aai
aaa
"}
