"a" = (/turf/open/floor/carpet,/area/shuttle/escape)
"b" = (/obj/effect/portal/permanent{id = "10-15"},/turf/open/floor/carpet,/area/shuttle/escape)
"l" = (/obj/effect/portal/permanent{id = "3-10"},/turf/open/floor/carpet,/area/shuttle/escape)
"T" = (/obj/effect/portal/permanent{id = "8-10"},/turf/open/floor/carpet,/area/shuttle/escape)

(1,1,1) = {"
aTa
bal
aaa
"}
