"a" = (/turf/open/floor/carpet,/area/shuttle/escape)
"j" = (/obj/effect/portal/permanent{id = "1-12"},/turf/open/floor/carpet,/area/shuttle/escape)
"J" = (/obj/effect/portal/permanent{id = "12-5"},/turf/open/floor/carpet,/area/shuttle/escape)
"Z" = (/obj/effect/portal/permanent{id = "11-12"},/turf/open/floor/carpet,/area/shuttle/escape)

(1,1,1) = {"
aZa
jaJ
aaa
"}
