"a" = (/turf/open/floor/carpet,/area/shuttle/escape)
"p" = (/obj/effect/portal/permanent{id = "3-14"},/turf/open/floor/carpet,/area/shuttle/escape)
"s" = (/obj/effect/portal/permanent{id = "8-14"},/turf/open/floor/carpet,/area/shuttle/escape)
"w" = (/obj/effect/portal/permanent{id = "7-14"},/turf/open/floor/carpet,/area/shuttle/escape)
"x" = (/obj/effect/portal/permanent{id = "14-2"},/turf/open/floor/carpet,/area/shuttle/escape)

(1,1,1) = {"
awa
sap
axa
"}
