"a" = (/turf/open/floor/carpet,/area/shuttle/escape)
"d" = (/obj/effect/portal/permanent{id = "3-5"},/turf/open/floor/carpet,/area/shuttle/escape)
"j" = (/obj/effect/portal/permanent{id = "5-6"},/turf/open/floor/carpet,/area/shuttle/escape)
"C" = (/obj/effect/portal/permanent{id = "12-5"},/turf/open/floor/carpet,/area/shuttle/escape)

(1,1,1) = {"
ada
Caj
aaa
"}
