//MAP CONVERTED BY dmm2tgm.py THIS HEADER COMMENT PREVENTS RECONVERSION, DO NOT REMOVE
"aa" = (
/turf/open/space/bluespace,
/area/hilbertshotel)
"ab" = (
/turf/closed/indestructible/hotelwall,
/area/hilbertshotel)
"ac" = (
/obj/machinery/jukebox{
	req_access = null
	},
/turf/open/indestructible/hotelwood,
/area/hilbertshotel)
"ad" = (
/turf/open/indestructible/hotelwood,
/area/hilbertshotel)
"ae" = (
/obj/structure/table/wood,
/turf/open/indestructible/hotelwood,
/area/hilbertshotel)
"af" = (
/obj/structure/table/wood,
/obj/structure/showcase/machinery/tv,
/obj/machinery/light/small{
	dir = 1
	},
/turf/open/indestructible/hotelwood,
/area/hilbertshotel)
"ag" = (
/obj/structure/dresser,
/turf/open/indestructible/hotelwood,
/area/hilbertshotel)
"ah" = (
/obj/structure/table/wood/fancy,
/turf/open/indestructible/hotelwood,
/area/hilbertshotel)
"ai" = (
/obj/structure/table/wood/fancy,
/obj/structure/mirror{
	pixel_y = 24
	},
/obj/machinery/light/small{
	dir = 1
	},
/turf/open/indestructible/hotelwood,
/area/hilbertshotel)
"aj" = (
/obj/structure/table/wood/fancy,
/obj/item/flashlight/lamp/green,
/turf/open/indestructible/hotelwood,
/area/hilbertshotel)
"an" = (
/obj/effect/spawner/xmastree,
/turf/open/indestructible/hotelwood,
/area/hilbertshotel)
"ap" = (
/obj/structure/mineral_door/wood,
/turf/open/indestructible/hotelwood,
/area/hilbertshotel)
"aq" = (
/obj/structure/bed,
/obj/item/bedsheet/random,
/turf/open/indestructible/hotelwood,
/area/hilbertshotel)
"ar" = (
/obj/structure/closet/cabinet{
	anchored = 1
	},
/turf/open/indestructible/hotelwood,
/area/hilbertshotel)
"at" = (
/obj/machinery/light/small{
	dir = 8
	},
/turf/open/indestructible/hotelwood,
/area/hilbertshotel)
"au" = (
/obj/structure/mineral_door/paperframe,
/turf/open/indestructible/hotelwood,
/area/hilbertshotel)
"av" = (
/obj/structure/extinguisher_cabinet{
	pixel_x = 32
	},
/turf/open/indestructible/hotelwood,
/area/hilbertshotel)
"aw" = (
/turf/open/indestructible/hoteltile,
/area/hilbertshotel)
"ax" = (
/obj/structure/curtain,
/turf/open/indestructible/hoteltile,
/area/hilbertshotel)
"ay" = (
/obj/machinery/door/window/northleft,
/turf/open/indestructible/hotelwood,
/area/hilbertshotel)
"az" = (
/obj/structure/table/reinforced,
/turf/open/indestructible/hotelwood,
/area/hilbertshotel)
"aA" = (
/obj/structure/mirror{
	pixel_x = -32
	},
/obj/structure/sink{
	dir = 8;
	pixel_x = -12;
	pixel_y = 2
	},
/turf/open/indestructible/hoteltile,
/area/hilbertshotel)
"aB" = (
/obj/structure/chair/stool/bar,
/turf/open/indestructible/hotelwood,
/area/hilbertshotel)
"aC" = (
/obj/machinery/shower{
	dir = 8
	},
/turf/open/indestructible/hoteltile,
/area/hilbertshotel)
"aD" = (
/obj/machinery/light_switch{
	pixel_x = 32
	},
/turf/open/indestructible/hotelwood,
/area/hilbertshotel)
"aE" = (
/obj/structure/table/reinforced,
/obj/item/soap/deluxe,
/turf/open/indestructible/hoteltile,
/area/hilbertshotel)
"aF" = (
/obj/structure/window/reinforced/tinted{
	dir = 8
	},
/obj/structure/window/reinforced/tinted{
	dir = 1
	},
/turf/open/indestructible/hoteltile,
/area/hilbertshotel)
"aG" = (
/obj/machinery/light_switch{
	pixel_x = -32
	},
/turf/open/indestructible/hotelwood,
/area/hilbertshotel)
"aH" = (
/obj/structure/table/reinforced,
/obj/machinery/microwave,
/turf/open/indestructible/hotelwood,
/area/hilbertshotel)
"aI" = (
/turf/closed/indestructible/hoteldoor,
/area/hilbertshotel)
"aJ" = (
/obj/machinery/light/small,
/turf/open/indestructible/hotelwood,
/area/hilbertshotel)
"aK" = (
/obj/structure/closet/crate/bin,
/obj/machinery/light/small{
	dir = 4
	},
/turf/open/indestructible/hotelwood,
/area/hilbertshotel)
"aL" = (
/obj/machinery/light/small{
	dir = 1
	},
/turf/open/indestructible/hoteltile,
/area/hilbertshotel)
"aM" = (
/obj/structure/table/reinforced,
/obj/machinery/light/small{
	dir = 4
	},
/turf/open/indestructible/hotelwood,
/area/hilbertshotel)
"aN" = (
/obj/structure/table/reinforced,
/obj/item/soap/deluxe,
/obj/machinery/light/small{
	dir = 8
	},
/turf/open/indestructible/hoteltile,
/area/hilbertshotel)
"aO" = (
/obj/item/bikehorn/rubberducky,
/obj/machinery/light/small{
	dir = 4
	},
/turf/open/indestructible/hoteltile,
/area/hilbertshotel)
"aP" = (
/obj/machinery/light/small,
/turf/open/indestructible/hoteltile,
/area/hilbertshotel)
"aQ" = (
/obj/machinery/smartfridge/food,
/turf/open/indestructible/hotelwood,
/area/hilbertshotel)
"aR" = (
/obj/structure/toilet{
	dir = 8
	},
/obj/structure/window/reinforced/tinted{
	dir = 1
	},
/obj/structure/window/reinforced/tinted{
	dir = 8
	},
/turf/open/indestructible/hoteltile,
/area/hilbertshotel)
"aS" = (
/obj/structure/window/reinforced/tinted{
	dir = 8
	},
/turf/open/indestructible/hoteltile,
/area/hilbertshotel)
"aT" = (
/obj/structure/window/reinforced/tinted{
	dir = 8
	},
/obj/structure/window/reinforced/tinted,
/turf/open/indestructible/hoteltile,
/area/hilbertshotel)
"aU" = (
/obj/structure/table/reinforced,
/obj/structure/sink/kitchen,
/obj/machinery/light/small,
/turf/open/indestructible/hotelwood,
/area/hilbertshotel)
"aV" = (
/obj/structure/table/reinforced,
/obj/effect/spawner/lootdrop/three_course_meal,
/turf/open/indestructible/hotelwood,
/area/hilbertshotel)
"aW" = (
/obj/structure/table/wood/fancy,
/obj/item/food/grown/poppy,
/turf/open/indestructible/hotelwood,
/area/hilbertshotel)
"aX" = (
/obj/structure/table/wood/poker,
/obj/item/reagent_containers/food/drinks/coffee{
	pixel_x = -6;
	pixel_y = 2
	},
/obj/item/gps{
	pixel_x = 5;
	pixel_y = 5
	},
/turf/open/indestructible/hotelwood,
/area/hilbertshotel)
"aY" = (
/obj/structure/chair/comfy/brown{
	dir = 1
	},
/turf/open/indestructible/hotelwood,
/area/hilbertshotel)
"aZ" = (
/obj/structure/chair/comfy/brown{
	dir = 4
	},
/obj/machinery/light/small{
	dir = 8
	},
/turf/open/indestructible/hotelwood,
/area/hilbertshotel)
"wA" = (
/obj/structure/table/wood/poker,
/obj/item/gps{
	pixel_x = -5;
	pixel_y = 5
	},
/obj/item/reagent_containers/food/drinks/coffee{
	pixel_x = 9;
	pixel_y = 2
	},
/turf/open/indestructible/hotelwood,
/area/hilbertshotel)
"Cb" = (
/obj/structure/closet/emcloset,
/turf/open/indestructible/hotelwood,
/area/hilbertshotel)
"DB" = (
/obj/structure/table/wood/poker,
/obj/item/paper/crumpled/hilbertsstaffnotice{
	pixel_y = 3
	},
/turf/open/indestructible/hotelwood,
/area/hilbertshotel)
"GY" = (
/obj/structure/chair/comfy/brown{
	dir = 8
	},
/obj/machinery/light/small{
	dir = 4
	},
/turf/open/indestructible/hotelwood,
/area/hilbertshotel)

(1,1,1) = {"
aa
aa
aa
aa
aa
aa
aa
aa
aa
aa
aa
aa
aa
aa
aa
"}
(2,1,1) = {"
aa
ab
ab
ab
ab
ab
aI
ab
ab
ab
ab
ab
ab
ab
aa
"}
(3,1,1) = {"
aa
ab
Cb
ad
aZ
ad
ad
at
ad
ay
at
aH
az
ab
aa
"}
(4,1,1) = {"
aa
ab
ae
ad
aX
aY
ad
ad
aB
az
ad
ad
az
ab
aa
"}
(5,1,1) = {"
aa
ab
af
ad
DB
aY
ad
ad
aB
aV
ad
ad
aU
ab
aa
"}
(6,1,1) = {"
aa
ab
ae
ad
wA
aY
ad
ad
aB
az
ad
ad
az
ab
aa
"}
(7,1,1) = {"
aa
ab
ac
ad
GY
ad
aD
aK
av
az
aM
aQ
az
ab
aa
"}
(8,1,1) = {"
aa
ab
ab
ab
ab
ap
ab
ab
ab
ab
ab
ab
ab
ab
aa
"}
(9,1,1) = {"
aa
ab
ag
ad
at
ad
aG
au
aw
aA
aN
aA
aE
ab
aa
"}
(10,1,1) = {"
aa
ab
ah
ad
ad
ad
ad
ab
aw
aw
aw
aw
aw
ab
aa
"}
(11,1,1) = {"
aa
ab
ai
ad
an
ad
aJ
ab
aL
aw
aR
aw
aP
ab
aa
"}
(12,1,1) = {"
aa
ab
ah
ad
ad
ad
ar
ab
ax
aF
aS
aT
ax
ab
aa
"}
(13,1,1) = {"
aa
ab
ad
ad
ad
ad
ad
ab
aw
aw
aw
aw
aw
ab
aa
"}
(14,1,1) = {"
aa
ab
ad
aj
aq
aq
aW
ab
aw
aC
aO
aC
aw
ab
aa
"}
(15,1,1) = {"
aa
ab
ab
ab
ab
ab
ab
ab
ab
ab
ab
ab
ab
ab
aa
"}
(16,1,1) = {"
aa
aa
aa
aa
aa
aa
aa
aa
aa
aa
aa
aa
aa
aa
aa
"}
